0000000000000
000000A000000
00000ACA00000
0000ACACA0000
000ACAAACA000
0000DCACD0000
00000DCD00000
00A000D000A00
0ABA00000ABA0
ABABA000ABABA
0ABA00000ABA0
00A0000000A00
0000AAAAA0000
00000ACA00000
000A00D00A000
000BA000AB000
0000BA0AB0000
00000BAB00000
000000B000000
