A00000000000A
CA000000000AC
CCA0000000ACC
ACCA00000ACCA
AACCA000ACCAA
AAACCA0ACCAAA
AAAACC0CCAAAA
AAAAAA0AAAAAA
AAAACC0CCAAAA
AAACCA0ACCAAA
AACCA000ACCAA
ACCA00000ACCA
CCA0000000ACC
CA0000A0000AC
A0000ABA0000A
0000AB0BA0000
000AB000BA000
000B00000B000

